Rank,Country,Gold,Silver,Bronze,Total,Population (2023)
1,United States,30,38,35,103,"345,426,571"
2,China,29,25,19,73,"1,425,671,352"
3,Australia,18,14,13,45,"26,966,789"
4,France,14,19,21,54,"66,438,822"
5,Great Britain,13,17,21,51,"68,682,962"
6,South Korea,13,8,7,28,"51,748,739"
7,Japan,13,7,13,33,"123,294,513"
8,Netherlands,11,6,8,25,"17,618,299"
9,Italy,10,11,9,30,"59,499,453"
10,Germany,9,8,5,22,"83,294,633"
